1111111
1001011
1010001
1c00101
1000001
1000cp1
1e10001
1c10001
1111111